*********************************************
*S *   *  * *       *     *   * * *   *  *  *
*    *   *  *   **  *  *  **  *    *  *   * *
*  **  *       *   *   **  *      *   **  ***
**  *   * *  *    *  * *  *   *    *    *   *
* * ***  *   * **  *   **  *  *  *   *    * *
**       *  **  *  *  ** *  *  * *   *     **
*** *  * *  *  *    *  *       *   *   *   **
*   *  *   * *   *  ***   *   *  * *  ***   *
*  *  ** * * *  *    *  **   *  *   * *   * *
**  *        *   * *  * *  *  *  * **  *  * *
*  **  *  *   * *   *  *  **  * *  * * ***  *
*   *   * *  *  *   **   *   *     *   *F*  *
* *    *  **  *   *  *   *  ***  **   *     *
*********************************************