***********
*    S    *
***** *****
*         *********
******           ?*
*         *********
*    ******
*         *
******    *
*F        *
***********