********************
*S   *             *
*    ****  ******  *
*          *      **
*    *******    ** *
*    **?**   ***   *
** **** **** *******
*       *        F *
********************