*******************************
*?  **    *     *       ** S  *
**   *    *?*   *       *     *
*   **    *** ***   *****     *
*                             *
*** **    *****************  **
*? *  *                      **
*     ****  *****************F*
***      *              *     *
*?  *            *            *
*******************************