*********************
*S          *       *
* *** * *** * * *** *
* *   *   *   *     *
* * *** * *** * *   *
*   *   *   * * *   *
*** * *** * *   * * *
*     *   * * *   * *
* *       *   * * * *
* ***** * *** * * * *
*   *   *       * * *
* ***** * ***** *** *
*       *   *      F*
*********************